AI	AY
AI(2)	EY AY
BENJAMIN	B EH N JH AH M AH N
BIRTHDAY	B ER TH D EY B ER TH D EY B ER TH D EY
DAYS	D EY Z
ERIK	EH R IH K
HOW	HH AW
IS	IH Z
LONG	L AO NG
MANY	M EH N IY
OFTEN	AO F T AH N
OFTEN(2)	AO F AH N
SLEEP	S L IY P
TO	T UW
TO(2)	T IH
TO(3)	T AH
UNTIL	AH N T IH L
WHEN	W EH N
WHEN(2)	HH W EH N
WHEN(3)	W IH N
WHEN(4)	HH W IH N
